# Syntax Coloring Map For AS5X47

# Datatypes (KEYWORD1)
Errfl	KEYWORD1		DATA_TYPE
Prog	KEYWORD1		DATA_TYPE
Diaagc	KEYWORD1		DATA_TYPE
Mag	KEYWORD1		DATA_TYPE
Angle	KEYWORD1		DATA_TYPE
Anglecom	KEYWORD1		DATA_TYPE
Zposm	KEYWORD1		DATA_TYPE
Zposl	KEYWORD1		DATA_TYPE
Settings1	KEYWORD1		DATA_TYPE
Settings2	KEYWORD1		DATA_TYPE
CommandFrame	KEYWORD1		DATA_TYPE
ReadDataFrame	KEYWORD1		DATA_TYPE
WriteDataFrame	KEYWORD1		DATA_TYPE
AS5X47	KEYWORD1		DATA_TYPE

# Methods and Functions (KEYWORD2)
readRegister	KEYWORD2
writeRegister	KEYWORD2
readAngle	KEYWORD2
writeSettings1	KEYWORD2
writeSettings2	KEYWORD2
writeZeroPosition	KEYWORD2
printDebugString	KEYWORD2

# Instances (KEYWORD2)

# Structures (KEYWORD3)
raw	KEYWORD3
values	KEYWORD3

# Constants (LITERAL1)
NOP_REG	LITERAL1	RESERVED_WORD_2
ERRFL_REG	LITERAL1	RESERVED_WORD_2
PROG_REG	LITERAL1	RESERVED_WORD_2
DIAGAGC_REG	LITERAL1	RESERVED_WORD_2
MAG_REG	LITERAL1	RESERVED_WORD_2
ANGLE_REG	LITERAL1	RESERVED_WORD_2
ANGLECOM_REG	LITERAL1	RESERVED_WORD_2
ZPOSM_REG	LITERAL1	RESERVED_WORD_2
ZPOSL_REG	LITERAL1	RESERVED_WORD_2
SETTINGS1_REG	LITERAL1	RESERVED_WORD_2
SETTINGS2_REG	LITERAL1	RESERVED_WORD_2
WRITE	LITERAL1	RESERVED_WORD_2
READ	LITERAL1	RESERVED_WORD_2
